                                  <MENU>	JpegQControl
                            iCustQCen_FW	0
                          iCustQCMode_FW	1
                          iCustQvalue_FW	100
                  cCustQtableFileName_FW	std_qtbl.txt
                                  <MENU>	ConvBinParam
                        cTxtLUTInpFolder	res
                        cBinLUTInpFolder	res
                       cTxtLUTOutpFolder	dbg
                       cBinLUTOutpFolder	res\bin
                         cCodeOutpFolder	res\code
                                  <MENU>	iControlBox1
                              cTStamp_FW	"下午 07:44:57 2013/1/8"
                                  <MENU>	ImageOutput
                                    outn	57
                                  <MENU>	MainPipe
                            cRawFileName	PV0054-ISO100.RAW
                        cRandRawFiles_FW	:
                           cDarkFileName	pic42w.ra2
                                      iW	1920
                                      iH	1080
                                 iISOSel	1
                              iColorTemp	3
                                   iZoom	0
                                  <MENU>	RawInput
                            iProcessMode	0
                                 iRawfmt	10
                                iRawtype	2
                                   iVPSf	1
                                 iFlipud	1
                            iIPWOIColOff	0
                            iIPWOIRowOff	0
                             iIPWOIWidth	1920
                            iIPWOIHeight	1080
                                iCSfmten	0
                             iEndiantype	1
                           iBitsperpixel	12
                             iVBytessize	7296
                                  <MENU>	FPGA
                                   iFPGA	0
                                   iSnap	1
                                  iImgno	0
                                  iBinno	0
                                   iBlkw	256
                                   iBlkh	100
                                   iDstw	768
                                   iDsth	512
                                  <MENU>	LensShading
                             iLenscorren	1
                                 iChmode	1
                               iFracBits	4
                                  iStepW	8
                                  iStepH	8
                              iSimlensen	0
                             fFalloffper	0.8
                        cLensLUTFileName	test_lenslut
                              iLSGain_FW	100
                                  <MENU>	WhiteBalance
                                iOBen_FW	0
                                iWBoffen	1
                                     iRo	-190
                                    iGro	-190
                                     iBo	-200
                                    iGbo	-190
                                 iWBgaen	0
                                     fRg	1.365234375
                                    fGrg	1
                                     fBg	1.2802734375
                                    fGbg	1
                              iEVGain_FW	1
                                  <MENU>	RawHScale
                              iRawHSclen	0
                               fRawHSclf	0.875
                             fRawPixoff1	0.9375
                             fRawPixoff2	0.875
                                  <MENU>	ARD
                                  iARDen	1
                                rawlevel	1
                                    iXf0	0
                                    iXf1	0
                                   iGGf0	1
                                   iGGf1	1
                                   iRBf0	9
                                   iRBf1	9
                                   iGGn0	0
                                   iGGn1	0
                                   iRBn0	3
                                   iRBn1	3
                                  iSmooR	64
                                  iSmooG	64
                                  iSmooB	64
                                 iNLThrR	1400
                                 iNLThrG	1400
                                 iNLThrB	1400
                                 iNHThrR	2047
                                 iNHThrG	2047
                                 iNHThrB	2047
                                  iConsR	32
                                  iConsG	32
                                  iConsB	32
                               iArdShren	0
                                 iArdDiv	1048576
                             iArdFreDNen	1
                                iFreThrG	128
                               iFreThrRB	128
                                iNNLThrG	1400
                               iNNLThrRB	1400
                                iPNLThrG	1400
                               iPNLThrRB	1400
                           cRVarFileName	ARD100R.TXT
                           cGVarFileName	ARD100G.TXT
                           cBVarFileName	ARD100B.TXT
                                  <MENU>	ARDDePeak
                                  iDPRen	1
                                  iDPGen	1
                                  iDPBen	1
                                   iRdif	16
                                   iRLoY	0
                                 iRSlope	10
                                 iRratio	255
                                   iGdif	16
                                   iGLoY	0
                                 iGSlope	10
                                 iGratio	255
                                   iBdif	16
                                   iBLoY	0
                                 iBSlope	10
                                 iBratio	255
                                  iRPDif	32
                                  iRNDif	32
                                  iGPDif	32
                                  iGNDif	32
                                  iBPDif	32
                                  iBNDif	32
                                iRCntthr	7
                                iGCntthr	7
                                iBCntthr	7
                                  <MENU>	Demosaic
                                 iEdgthr	4095
                                 iLowthr	50
                              iSmoothsel	0
                                  iHFthr	0
                                iSlntthr	16
                                iGradOpt	0
                                iClipOpt	1
                                  iAbsE0	2
                                  iAbsE1	4
                                  iAbsE2	8
                                  iAbsE3	16
                                  iAbsE4	32
                                  iAbsE5	64
                                  iAbsE6	128
                                  iAbsE7	255
                                  iAbsG0	255
                                  iAbsG1	128
                                  iAbsG2	64
                                  iAbsG3	32
                                  iAbsG4	16
                                  iAbsG5	8
                                  iAbsG6	4
                                  iAbsG7	2
                                iNLThrAc	2047
                                iNLThrSo	7
                                   iAcen	1
                               iAcEdgThr	1023
                               iAcPatThr	7
                                  iAcShr	255
                                  iSoShr	1
                              iSobCntThr	5
                                  <MENU>	VectorMedian
                                 iVMFRen	1
                                 iVMFGen	1
                                 iVMFBen	1
                                    iHFW	6
                                  <MENU>	PreWhiteClip
                                iPreWCen	0
                                iPreWCCh	1
                              iPreWCXThr	3072
                              iPreWCYThr	3072
                              iPreWCXLev	32
                              iPreWCYLev	32
                                iPreDCen	0
                                iPreDCCh	2
                              iPreDCXThr	240
                              iPreDCYThr	240
                              iPreDCXLev	32
                              iPreDCYLev	32
                                  <MENU>	WDRrgb
                               iRGBWDRen	0
                                 iRGBQfH	1331
                              iRGBQSlope	547
                               iRGBYqthr	640
                                  iRGBKs	255
                                iRGBCoeQ	128
                                iRGBYoff	0
                                 iRGBYga	1
                                  iRfthr	1024
                                  iGfthr	1024
                                  iBfthr	1024
                        cRGBQLUTFileName	RGBQ1024.txt
                                  <MENU>	ColorMatrix
                                 iMtrxen	1
                                    fC11	1.671875
                                    fC12	-0.375
                                    fC13	-0.296875
                                    fC21	-0.34375
                                    fC22	1.421875
                                    fC23	-0.0625
                                    fC31	0.015625
                                    fC32	-0.53125
                                    fC33	1.53125
                                  <MENU>	ColorMatrix2
                                iMtrx2en	0
                                    fD11	1
                                    fD12	0
                                    fD13	0
                                    fD21	0
                                    fD22	1
                                    fD23	0
                                    fD31	0
                                    fD32	0
                                    fD33	1
                                  <MENU>	RGBGamma
                             iPreGammaen	0
                             iTriGammaen	0
                          iPosGammainven	0
                             iRGBGammaen	1
                         cGGammaFileName	G_gamma.txt
                         cRGammaFileName	R_gamma.txt
                         cBGammaFileName	B_gamma.txt
                                  <MENU>	PosWhiteClip
                                iPosWCen	0
                                iPosWCCh	0
                              iPosWCXThr	192
                              iPosWCYThr	192
                              iPosWCXLev	32
                              iPosWCYLev	32
                                iPosDCen	0
                                iPosDCCh	1
                              iPosDCXThr	15
                              iPosDCYThr	15
                              iPosDCXLev	32
                              iPosDCYLev	32
                                  <MENU>	CA
                                   iCAen	0
                                  iCAOpt	0
                                   iP1Xn	24
                                   iP1Yn	20
                                   iP2Xn	32
                                   iP2Yn	24
                              iGridStepW	512
                              iGridStepH	256
                                iTblXSze	20
                                iTblYSze	15
                          cCADevFileName	CAsimI.txt
                                  <MENU>	LUT3D
                                iLUT3Den	0
                          cLUT3DFileName	test_lut3d
                                  <MENU>	HueCorrection
                                   iHCen	1
                                  iCRmin	4
                                  iCBmin	4
                                iHCLoThr	8
                                  iHCWid	3
                         cCOSTblFileName	ca_cos_m.txt
                         cSINTblFileName	ca_sin_m.txt
                         cSATTblFileName	hc_sat_m.txt
                                  <MENU>	YGamma
                               iYGammaen	0
                            iYGammainven	0
                         cYGammaFileName	test_ygamma_m
                                  <MENU>	WDRyuv
                               iYUVWDRen	0
                                 iYUVQfH	1331
                              iYUVQSlope	5
                               iYUVYqthr	640
                                  iYUVKs	160
                                iYUVCoeQ	192
                                iYUVYoff	128
                                 iYUVYga	8
                                 iCbfthr	384
                                 iCrfthr	384
                        cYUVQLUTFileName	YUVQ1024.txt
                                  <MENU>	YEE
                                 iYEdgen	1
                                 iYGLUT0	5
                                 iYGLUT1	14
                                 iYGLUT2	27
                                 iYGLUT3	43
                                 iYGLUT4	61
                                 iYGLUT5	81
                                 iYGLUT6	103
                                 iYGLUT7	127
                                 iYGLUT8	151
                                 iYGLUT9	173
                                iYGLUT10	193
                                iYGLUT11	211
                                iYGLUT12	226
                                iYGLUT13	255
                                iYGLUT14	255
                                iYGLUT15	255
                                   iMsk0	40
                                   iMsk1	-1
                                   iMsk2	-1
                                   iMsk3	-3
                                   iMsk4	-2
                                   iMsk5	-1
                               iYH_Hithr	85
                               iYH_Lothr	-85
                                iLUTPthr	28
                                iLUTNthr	-85
                                 fHFGain	180
                                  fYHDiv	2
                                 fYHTDiv	4
                                   fYDiv	2
                        cEEdgLUTFileName	Edge_strong
                                   iCeen	0
                                iCetidx0	90
                                iCetidx1	418
                                iCetidx2	613
                                iCetidx3	928
                              iCetidxoff	0
                                  iCecol	63
                                  iCerow	47
                               iCeBitfac	1
                               iCeStpsze	128
                              iCeratioen	0
                                fCeratio	1.0
                          cCeLUTFileName	test_celut
                                  <MENU>	YNFYEF
                                 iYDbren	0
                                 iYWbren	0
                                 iSupXfs	10
                                 iSupXfe	11
                             iSupEdgYThr	5
                              iSupEdgDiv	2
                             iYDbrEdgPat	0
                             iYDbrFtrOpt	2
                             iYWbrFtrOpt	1
                                  iYDbrW	255
                                  iYWbrW	255
                                  <MENU>	AA
                                   iAAen	0
                                 iAAmode	1
                                  iPRmin	4
                                  iPBmin	4
                                 iAvgthr	255
                                  iVSkip	1
                                  iHSkip	1
                              iAAShrMode	0
                             iAAShrScale	4096
                              cYFileName	ca_yclip
                             cSUFileName	test_suclip
                             cSVFileName	test_svclip
                             cSSFileName	test_ssclip
                                  <MENU>	CBlur
                                 iCDbren	0
                                 iCWbren	0
                                  iIIRen	1
                             iSupEdgCThr	1
                             iCDbrFtrOpt	0
                             iCWbrFtrOpt	0
                                  iCDbrW	0
                                  iCWbrW	0
                               iCDbrMode	0
                               iCWbrMode	0
                           iM1CDbrFtrOpt	0
                             iCDbrEdgPat	0
                                 iMedThr	4
                                iMedLUT0	1
                                iMedLUT1	16
                                iMedLUT2	32
                                iMedLUT3	48
                                iMedLUT4	64
                                iMedLUT5	80
                                iMedLUT6	96
                                iMedLUT7	112
                                iMedLUT8	128
                                iMedLUT9	144
                               iMedLUT10	160
                               iMedLUT11	176
                               iMedLUT12	192
                               iMedLUT13	208
                               iMedLUT14	224
                               iMedLUT15	240
                               iMedLUT16	255
                                  <MENU>	AHD
                                  iAHDen	1
                                iAHDmode	0
                                  fSmooy	64
                                 fSmoocr	64
                                 fSmoocb	64
                                 fNLThry	1200
                                fNLThrcr	1200
                                fNLThrcb	1200
                                 fNHThry	2048
                                fNHThrcr	2048
                                fNHThrcb	2048
                                  fConsy	32
                                 fConscr	32
                                 fConscb	32
                                    iYf0	3
                                    iCf0	3
                                 fSmooy2	64
                                fSmoocr2	64
                                fSmoocb2	64
                                fNLThry2	1200
                               fNLThrcr2	1200
                               fNLThrcb2	1200
                                fNHThry2	2048
                               fNHThrcr2	2048
                               fNHThrcb2	2048
                                 fConsy2	32
                                fConscr2	32
                                fConscb2	32
                                    iYf1	3
                                    iCf1	3
                                 fSmooy3	64
                                fSmoocr3	64
                                fSmoocb3	64
                                fNLThry3	1200
                               fNLThrcr3	1200
                               fNLThrcb3	1200
                                fNHThry3	2048
                               fNHThrcr3	2048
                               fNHThrcb3	2048
                                 fConsy3	32
                                fConscr3	32
                                fConscb3	32
                                    iYf2	7
                                    iCf2	3
                                 fSmooy4	64
                                fSmoocr4	64
                                fSmoocb4	64
                                fNLThry4	1200
                               fNLThrcr4	1200
                               fNLThrcb4	1200
                                fNHThry4	2048
                               fNHThrcr4	2048
                               fNHThrcb4	2048
                                 fConsy4	32
                                fConscr4	32
                                fConscb4	32
                                    iYf3	7
                                    iCf3	7
                                 fSmooy5	64
                                fSmoocr5	64
                                fSmoocb5	64
                                fNLThry5	1200
                               fNLThrcr5	1200
                               fNLThrcb5	1200
                                fNHThry5	2048
                               fNHThrcr5	2048
                               fNHThrcb5	2048
                                 fConsy5	32
                                fConscr5	32
                                fConscb5	32
                                    iYf4	7
                                    iCf4	7
                                iFreDNen	1
                                fFreThry	11
                                fPNLThry	128
                                fNNLThry	512
                           cYVarFileName	AHD100Y.TXT
                          cCrVarFileName	AHD100Cr.TXT
                          cCbVarFileName	AHD100Cb.TXT
                                   iYThr	4
                                   iCThr	4
                                     iYg	160
                                     iCg	0
                                  <MENU>	AHD-AA
                                  iFAAen	0
                                iFAAmode	1
                                 iFPRmin	4
                                 iFPBmin	4
                                iFAvgthr	255
                                 iFVSkip	1
                                 iFHSkip	1
                             iFAAShrMode	0
                            iFAAShrScale	65536
                          cFyLUTFileName	ca_yclip
                         cFsuLUTFileName	test_suclip
                         cFsvLUTFileName	test_svclip
                         cFssLUTFileName	test_ssclip
                                  <MENU>	AHD-CBlur
                                iFCDbren	0
                                iFCWbren	0
                                 iFIIRen	0
                            iFSupEdgCThr	20
                            iFCDbrFtrOpt	0
                            iFCWbrFtrOpt	0
                                 iFCDbrW	0
                                 iFCWbrW	0
                              iFCDbrMode	0
                              iFCWbrMode	0
                          iFM1CDbrFtrOpt	2
                            iFCDbrEdgPat	0
                                iFMedThr	4
                               iFMedLUT0	1
                               iFMedLUT1	16
                               iFMedLUT2	32
                               iFMedLUT3	48
                               iFMedLUT4	64
                               iFMedLUT5	80
                               iFMedLUT6	96
                               iFMedLUT7	112
                               iFMedLUT8	128
                               iFMedLUT9	144
                              iFMedLUT10	160
                              iFMedLUT11	176
                              iFMedLUT12	192
                              iFMedLUT13	208
                              iFMedLUT14	224
                              iFMedLUT15	240
                              iFMedLUT16	255
                                  <MENU>	Pre-YEE
                                iBYEdgen	0
                                iBYGLUT0	5
                                iBYGLUT1	14
                                iBYGLUT2	27
                                iBYGLUT3	43
                                iBYGLUT4	61
                                iBYGLUT5	81
                                iBYGLUT6	103
                                iBYGLUT7	127
                                iBYGLUT8	151
                                iBYGLUT9	173
                               iBYGLUT10	193
                               iBYGLUT11	211
                               iBYGLUT12	226
                               iBYGLUT13	255
                               iBYGLUT14	255
                               iBYGLUT15	255
                                  iBMsk0	40
                                  iBMsk1	-1
                                  iBMsk2	-1
                                  iBMsk3	-3
                                  iBMsk4	-2
                                  iBMsk5	-1
                              iBYH_Hithr	197
                              iBYH_Lothr	-201
                               iBLUTPthr	190
                               iBLUTNthr	-100
                                fBHFGain	128
                                 fBYHDiv	2
                                fBYHTDiv	1
                                  fBYDiv	1
                       cBEEdgLUTFileName	ca_ee100
                                  iBCeen	0
                               iBCetidx0	90
                               iBCetidx1	418
                               iBCetidx2	613
                               iBCetidx3	928
                             iBCetidxoff	0
                                 iBCecol	63
                                 iBCerow	47
                              iBCeBitfac	1
                              iBCeStpsze	128
                             iBCeratioen	0
                               fBCeratio	1.0
                         cBCeLUTFileName	test_celut
                                  <MENU>	Pre-YNFYEF
                                iBYDbren	0
                                iBYWbren	0
                                iBSupXfs	0
                                iBSupXfe	8
                            iBSupEdgYThr	20
                             iBSupEdgDiv	4
                            iBYDbrEdgPat	3
                            iBYDbrFtrOpt	2
                            iBYWbrFtrOpt	1
                                 iBYDbrW	0
                                 iBYWbrW	0
                                  <MENU>	Pre-AA
                                  iBAAen	0
                                iBAAmode	1
                                 iBPRmin	4
                                 iBPBmin	4
                                iBAvgthr	255
                                 iBVSkip	1
                                 iBHSkip	1
                             iBAAShrMode	1
                            iBAAShrScale	65536
                          cByLUTFileName	test_yclip
                         cBsuLUTFileName	test_suclip
                         cBsvLUTFileName	test_svclip
                         cBssLUTFileName	test_ssclip
                                  <MENU>	Pre-CBlur
                                iBCDbren	0
                                iBCWbren	0
                                 iBIIRen	0
                            iBSupEdgCThr	20
                            iBCDbrFtrOpt	0
                            iBCWbrFtrOpt	0
                                 iBCDbrW	0
                                 iBCWbrW	0
                              iBCDbrMode	0
                              iBCWbrMode	0
                          iBM1CDbrFtrOpt	2
                            iBCDbrEdgPat	0
                                iBMedThr	4
                               iBMedLUT0	1
                               iBMedLUT1	16
                               iBMedLUT2	32
                               iBMedLUT3	48
                               iBMedLUT4	64
                               iBMedLUT5	80
                               iBMedLUT6	96
                               iBMedLUT7	112
                               iBMedLUT8	128
                               iBMedLUT9	144
                              iBMedLUT10	160
                              iBMedLUT11	176
                              iBMedLUT12	192
                              iBMedLUT13	208
                              iBMedLUT14	224
                              iBMedLUT15	240
                              iBMedLUT16	255
                                  <MENU>	Redo-YEE
                                iRYEdgen	0
                                iRYGLUT0	5
                                iRYGLUT1	14
                                iRYGLUT2	27
                                iRYGLUT3	43
                                iRYGLUT4	61
                                iRYGLUT5	81
                                iRYGLUT6	103
                                iRYGLUT7	127
                                iRYGLUT8	151
                                iRYGLUT9	173
                               iRYGLUT10	193
                               iRYGLUT11	211
                               iRYGLUT12	226
                               iRYGLUT13	255
                               iRYGLUT14	255
                               iRYGLUT15	255
                                  iRMsk0	40
                                  iRMsk1	-1
                                  iRMsk2	-1
                                  iRMsk3	-3
                                  iRMsk4	-2
                                  iRMsk5	-1
                              iRYH_Hithr	197
                              iRYH_Lothr	-201
                               iRLUTPthr	190
                               iRLUTNthr	-100
                                fRHFGain	128
                                 fRYHDiv	2
                                fRYHTDiv	1
                                  fRYDiv	1
                       cREEdgLUTFileName	ca_ee100
                                  iRCeen	0
                               iRCetidx0	90
                               iRCetidx1	418
                               iRCetidx2	613
                               iRCetidx3	928
                             iRCetidxoff	0
                                 iRCecol	63
                                 iRCerow	47
                              iRCeBitfac	1
                              iRCeStpsze	128
                             iRCeratioen	0
                               fRCeratio	1.0
                         cRCeLUTFileName	test_celut
                                  <MENU>	Redo-YNFYEF
                                iRYDbren	0
                                iRYWbren	0
                                iRSupXfs	0
                                iRSupXfe	8
                            iRSupEdgYThr	20
                             iRSupEdgDiv	4
                            iRYDbrEdgPat	3
                            iRYDbrFtrOpt	2
                            iRYWbrFtrOpt	1
                                 iRYDbrW	0
                                 iRYWbrW	0
                                  <MENU>	Redo-AA
                                  iRAAen	0
                                iRAAmode	1
                                 iRPRmin	4
                                 iRPBmin	4
                                iRAvgthr	255
                                 iRVSkip	1
                                 iRHSkip	1
                             iRAAShrMode	0
                            iRAAShrScale	4096
                          cRyLUTFileName	test_yclip
                         cRsuLUTFileName	test_suclip
                         cRsvLUTFileName	test_svclip
                         cRssLUTFileName	test_ssclip
                                  <MENU>	Redo-CBlur
                                iRCDbren	0
                                iRCWbren	0
                                 iRIIRen	0
                            iRSupEdgCThr	20
                            iRCDbrFtrOpt	0
                            iRCWbrFtrOpt	0
                                 iRCDbrW	0
                                 iRCWbrW	0
                              iRCDbrMode	0
                              iRCWbrMode	0
                          iRM1CDbrFtrOpt	2
                            iRCDbrEdgPat	0
                                iRMedThr	4
                               iRMedLUT0	1
                               iRMedLUT1	16
                               iRMedLUT2	32
                               iRMedLUT3	48
                               iRMedLUT4	64
                               iRMedLUT5	80
                               iRMedLUT6	96
                               iRMedLUT7	112
                               iRMedLUT8	128
                               iRMedLUT9	144
                              iRMedLUT10	160
                              iRMedLUT11	176
                              iRMedLUT12	192
                              iRMedLUT13	208
                              iRMedLUT14	224
                              iRMedLUT15	240
                              iRMedLUT16	255
                                  <MENU>	Sketch
                               iSketchen	0
                          iSketchBaseVal	255
                                  <MENU>	DigitalEffect
                               iBriconen	0
                                   fConf	1
                                 iBrioff	9
                                  iBinen	0
                                 iBinthr	128
                                  iColen	0
                                    fA00	1
                                    fA01	-1
                                    fA10	1
                                    fA11	-1
                                  iCboff	-10
                                  iCroff	-20
                                  <MENU>	TempoFtr
                                   iTden	0
                               iTdYLoThr	20
                               iTdYHiThr	200
                               iTdFtrOpt	2
                              iTmpo_Ythr	0
                             iTmpo_Crthr	64
                             iTmpo_Cbthr	64
                              iTmpo_Ywid	32
                             iTmpo_Crwid	64
                             iTmpo_Cbwid	64
                              iCurr_Ylow	96
                             iCurr_Crlow	64
                             iCurr_Cblow	64
                              iCurr_Yhiw	255
                             iCurr_Crhiw	255
                             iCurr_Cbhiw	255
                                  <MENU>	LDC
                                   iLDen	0
                                 iLDType	1
                                 iLDBit1	8
                                 iLDBit2	16
                             iLDTblHStep	7
                             iLDTblVStep	7
                                  iKxMax	63774
                                  iKyMax	63774
                            iTblSignmode	0
                            iFisheyemode	1
                          cLDTblFileName	test_ldclut
                        iLDGainSelect_FW	0
                                iGain_FW	100
                          iFisheyeLvl_FW	100
                                  <MENU>	YCHScale
                              iYCHHalfen	0
                               iYCHSclen	0
                                fYCHSclf	0.75
                              fYCHPixoff	0.75
                                  <MENU>	YCVScale
                               iYCVSclen	0
                                fYCVSclf	0.83335
                              fYCVPixoff	0.83335
                                  <MENU>	AHD6330
                                iAHD6330	0
                              iFCDbrMode	0
                              iFCWbrMode	0
                            iFCDbrEdgPat	0
                          iFM1CDbrFtrOpt	2
                                iFMedThr	4
                               iFMedLUT0	1
                               iFMedLUT1	16
                               iFMedLUT2	32
                               iFMedLUT3	48
                               iFMedLUT4	64
                               iFMedLUT5	80
                               iFMedLUT6	96
                               iFMedLUT7	112
                               iFMedLUT8	128
                               iFMedLUT9	144
                              iFMedLUT10	160
                              iFMedLUT11	176
                              iFMedLUT12	192
                              iFMedLUT13	208
                              iFMedLUT14	224
                              iFMedLUT15	240
                              iFMedLUT16	255
                            iFSupEdgYThr	20
                            iFYDbrEdgPat	1
                            iFYDbrFtrOpt	0
                                 iFYDbrW	0
                                 iFYWbrW	255
                                  <MENU>	Zx-color-style
                                 fPreC11	1
                                 fPreC12	0
                                 fPreC13	0
                                 fPreC21	0
                                 fPreC22	1
                                 fPreC23	0
                                 fPreC31	0
                                 fPreC32	0
                                 fPreC33	1
                                 fPosC11	1
                                 fPosC12	0
                                 fPosC13	0
                                 fPosC21	0
                                 fPosC22	1
                                 fPosC23	0
                                 fPosC31	0
                                 fPosC32	0
                                 fPosC33	1
